Tiny Oasis I.
:::::::::::::::::::
:::::::::::::::::::
:::::::::::::::::::
::::::::420::::::::
:::::::33~04:::::::
::::::::113::::::::
:::::::::::::::::::
:::::::::::::::::::
:::::::::::::::::::