T-5: Move Your Mouse!
~~~~~~~~~~~~~~~~~~~
~~~~~~__~~_~~~~~~~~
~~~~~~~_~~__2~~~~~~
~~~~~~~_0___~~~~~~~
~~~~~~~1___~~~~~~~~
~~~~~~_____~~~~~~~~
~~~~~~_4_3___~~~~~~
~~~~~~~~__~~_~~~~~~
~~~~~~~~~~~~~~~~~~~
