T-2: Tiny Difference
~~~~~~~~~~~~~~~~~~~
~~~~~~~~~~~~~~~~~~~
~~~~~~~~~3~~~~~~~~~
~~~~~~~~~3~~~~~~~~~
~~~~~~~~142~~~~~~~~
~~~~~~~41323~~~~~~~
~~~~~~~~~~~~~~~~~~~
~~~~~~~~~~~~~~~~~~~
~~~~~~~~~~~~~~~~~~~
30 MSG A1 C1 Test