Tiny Islands II.
~~~~~~~~~~~~~~~~~~~
~~~~~~~~4~~~3~~~~~~
~~~~1~~1~~~~~~34~~~
~~~42~~~~~~0~~~~~~~
~~~~~~~4~~~02~~~~~~
~~~~30~~~~~~~~21~~~
~~~~2~~~~~10~~~~~~~
~~~~~~~~~~~4~~~~~~~
~~~~~~~~~~~~~~~~~~~
1 RESETABLE
