Ludum Island I.
~~~~~~~~~~~~~~~~~~~
~~~~~~~~~~~~~~~~~~~
~~~~~~~~~1~~~~~~~~~
~~~~~~~~~0~~~~~~~~~
~~~~~~~~204~~~~~~~~
~~~~~~~20433~~~~~~~
~~~~~~~~~~~~~~~~~~~
~~~~~~~~~~~~~~~~~~~
~~~~~~~~~~~~~~~~~~~
1 NEXT ludum-island-2
2 RESETABLE