Oasis
:::::::::::::::::::
:::::::00000:::::::
::::::0423110::::::
::::::014~330::::::
::::::03~~~40::::::
::::::031~320::::::
::::::0242410::::::
:::::::00000:::::::
:::::::::::::::::::
1 PREV tetris-islands-2
2 NEXT jin-jang-island