Tetris Islands II.
~~~~~~~~~~~~~~~~~~~
~000~~~~~~44~~4~2~~
~0~~~~~~~~33~23~2~~
~~~~~42~4~~~~1~~2~~
~~1~~32~41~~~~~~2~~
~~11~~~~~2~~4~~~~~~
~~1~~~23~~~~3~~44~~
~~~~~03~~~~12~~44~~
~~~~~~~~~~~~~~~~~~~
1 NEXT oasis
