Tiny Oasis II.
:::::::::::::::::::
:::::::::::::::::::
:::::::::::::::::::
::::::::420::::::::
:::::::33~04:::::::
::::::::310::::::::
:::::::::::::::::::
:::::::::::::::::::
:::::::::::::::::::
1 PREV ludum-island-3
2 NEXT tetris-islands-2