Tiny Islands I.
~~~~~~~~~~~~~~~~~~~
~~~~~~~~~~~~~~~~~~~
~~~~~~~~~~~~~~34~~~
~~~42~~~~~~0~~~~~~~
~~~~~~~~~~~0~~~~~~~
~~~~3~~~~~~~~~~~~~~
~~~~2~~~~~10~~~~~~~
~~~~~~~~~~~~~~~~~~~
~~~~~~~~~~~~~~~~~~~
1 PREV tutorial-3
2 NEXT tetris-islands-1
3 RESETABLE
