Two Ponds Island
~~~~~~~~~~~~~~~~~~~
~~~~~~~~000~~~~~~~~
~~~~~~~11111~~~~~~~
~~~~~~22~2222~~~~~~
~~~~~~3333333~~~~~~
~~~~~~2222~22~~~~~~
~~~~~~~44444~~~~~~~
~~~~~~~~000~~~~~~~~
~~~~~~~~~~~~~~~~~~~
1 PREV oasis
2 NEXT random-island