Ludum Island II.
~~~~~~~~~~~~~~~~~~~
~~~~~~~~~~~~~~~~~~~
~~~~~~~~~1~~~~~~~~~
~~~~~~~~~0~~~~~~~~~
~~~~~~~~302~~~~~~~~
~~~~~~~31423~~~~~~~
~~~~~~~~~~~~~~~~~~~
~~~~~~~~~~~~~~~~~~~
~~~~~~~~~~~~~~~~~~~
1 PREV ludum-island-1
2 NEXT tiny-oasis-1
3 RESETABLE