Random Island
~~~~~~~~~~~~~~~~~~~
~~~~~~??~~?~~~~~~~~
~~~~~~~?~~??2~~~~~~
~~~~~~~?0???~~~~~~~
~~~~~~~1???~~~~~~~~
~~~~~~?????~~~~~~~~
~~~~~~?4?3???~~~~~~
~~~~~~~~??~~?~~~~~~
~~~~~~~~~~~~~~~~~~~
1 NEXT full-random