Tetris Islands I.
~~~~~~~~~~~~~~~~~~~
~~~~~~~~~~~~~~13~~~
~~~~~4~~~~~~~~~2~~~
~~~~123~~~~04~~4~~~
~~~~~~~~~~~03~~~~~~
~~~43~~~~~~~~~~~~~~
~~~~21~~~~~~~~~~~~~
~~~~~~~~~1323~~~~~~
~~~~~~~~~~~~~~~~~~~
1 PREV tiny-islands-1
2 NEXT tiny-islands-2
3 RESETABLE
